##keys in Item.txt was origin from team RTLC, zh-tw translate by Voc-夜芷冰

#不可動的物品#
Luggage=行李箱
Big Luggage=大型行李箱
Explorer's Luggage=探險者行李箱
Ancient Luggage=古老行李箱
Chain=鏈條
Vine=藤蔓

#物品#
Bing Bong=兵幫
Conch=海螺
Backpack=背包
Granola Bar=燕麥棒
Trail Mix=果仁雜錦
Lantern=燈籠
Bugle=號角
Compass=指南針
Coconut=椰子
Coconut Half=半個椰子
anti-rope spool=抗繩捲軸
rope spool=繩索捲軸
Energy Drink=能量飲料
First Aid Kit=急救包
Bandages=繃帶
Bugle Shroom=號角菇
Cluster Shroom=叢生菇
Button Shroom=鈕扣菇
Chubby Shroom=胖菇
Weird Shroom=怪菇
Airline Food=飛機餐
Big Lollipop=大棒棒糖
Marshmallow=棉花糖
Faerie Lantern=仙女燈籠
Medicinal Root=藥草的根
Pirate's Compass=海盜指南針
piton=岩釘
Scout Cookies=童軍餅乾
Sports Drink=運動飲料
rope cannon=繩炮
anti-rope cannon=抗繩炮
Blowgun=吹箭管
Chain Launcher=鏈條發射器
Tick=蜱蟲
Heat Pack=暖暖包
Big Egg=巨蛋
Egg=炒蛋
Beehive=蜂窩
Honeycomb=蜜脾
Shelf Fungus=架菇
Remedy Fungus=療癒菇
Bounce Fungus=彈力菇
Cure-All=萬靈藥
Binoculars=雙筒望遠鏡
Turtle Flag=烏龜旗
Cursed Skull=詛咒頭骨
Pandora's Lunchbox=潘朵拉便當盒
Scout Effigy=童軍雕像
Scoutmaster's Bugle=童軍領袖號角
Warp Compass=傳送指南針
Scroll=捲軸
Stick=木棍
Stone=石頭
Megaphone=擴音器
Berrynana Peel=香蕉皮
Scorchberry=辣椒
Napberry=瞌睡莓
Antidote=解毒劑
Bugle of Friendship=朋友號角
Portable Stove=攜帶式爐具
Guidebook=求生指南
Flare=信號彈

##漿果##
Green Crispberry=綠色脆莓
Red Crispberry=紅色脆莓
Yellow Crispberry=黃色脆莓
Purple Crispberry=紫色脆莓
Black Crispberry=黑色脆莓
Blue Crispberry=藍色脆莓
Pink Crispberry=粉紅色脆莓
Brown Crispberry=棕色脆莓
Orange Crispberry=橙色脆莓
Green Kingberry=綠色王莓
Red Kingberry=紅色王莓
Yellow Kingberry=黃色王莓
Purple Kingberry=紫色王莓
Black Kingberry=黑色王莓
Blue Kingberry=藍色王莓
Pink Kingberry=粉紅色王莓
Brown Kingberry=棕色王莓
Orange Kingberry=橙色王莓
Green Clusterberry=綠色叢莓
Red Clusterberry=紅色叢莓
Yellow Clusterberry=黃色叢莓
Purple Clusterberry=紫色叢莓
Black Clusterberry=黑色叢莓
Blue Clusterberry=藍色叢莓
Pink Clusterberry=粉紅色叢莓
Brown Clusterberry=棕色叢莓
Orange Clusterberry=橙色叢莓
Green Winterberry=綠色冬莓
Red Winterberry=紅色冬莓
Yellow Winterberry=黃色冬莓
Purple Winterberry=紫色冬莓
Black Winterberry=黑色冬莓
Blue Winterberry=藍色冬莓
Pink Winterberry=粉紅色冬莓
Brown Winterberry=棕色冬莓
Orange Winterberry=橙色冬莓
Green Berrynana=綠色香蕉
Red Berrynana=紅色香蕉
Yellow Berrynana=黃色香蕉
Purple Berrynana=紫色香蕉
Black Berrynana=黑色香蕉
Blue Berrynana=藍色香蕉
Pink Berrynana=粉紅色香蕉
Brown Berrynana=棕色香蕉
Orange Berrynana=橙色香蕉
